.....Ex.
....xxx.
........
xxxx....
...x....
S.......