........
........
E.......
x.xxxxxx
.S......
........