......x..S
....xxx...
.........x
x.xx.....x
x..x...Ex.
x........x
....xxxx..