......x..E..
....xxx.....
.........x..
x.xx.....x..
x..x....x...
x........x..
....xxxx....
x........x..
....xxxx....
x........x..
....xxxx....
x........x..
....xxxxS...