.E...xx.........x.
....xxx...xx......
.........x........
x.xx.....x........
x..x....x.........
x........x........
....xxxx..........
....xxx...........
.........xxxxxxx..
x.xx.....x........
x..x....x.xxxx....
x..S.....x........
....xxxx..xxxxx.x.