xx.xx.xxxx.x.x.x........x..
S...x....x...x..x.x...x.x..
x..xx..x.x.x.x....x.x.x.xE.
x........x.x.x..x.x.x.x.x.x
x.x.x....x.x.x..x.x.x.x.x..
x..xx....x.x.x....x.x.x.xx.
x.x...x....x....x.x.x.x....
x...xxxxxx.x.x..x...x.x.x..